.,-_ '`!?:;­´"()[]<>{}/\*«»‘’‚‛“”„‟…=
а=А
б=Б
в=В
гЃѓҐґҒғ=Г
д=Д
еЁёЄє=Е
жҖҗ=Ж
з=З
иІіЇї=И
йЈј=Й
кЌќҚқҜҝ=К
лЉљ=Л
м=М
нЊњҢң=Н
оӨө=О
п=П
р=Р
с=С
т=Т
уЎўҮүҰұ=У
ф=Ф
хҲҳ=Х
ц=Ц
чЋћҸҹ=Ч
шҺһ=Ш
щ=Щ
ъ=Ъ
ы=Ы
ь=Ь
э=Э
ю=Ю
я=Я
